#################################
#...............................#
#..............E................#
#...............#...............#
#...............#...............#
#...............#...............#
#...............#...P...........#
#...............#...............#
#...............#...............#
#...............#...............#
#...............#...............#
##############..#################
#...............................#
#..........#....................#
#..........#....................#
#..........#....................#
#..........#...#................#
#..........#...#................#
#..........#...#................#
#.......E..#....................#
#..........######################
#...............................#
#...............................#
#################################