################################
#..............................#
#..............................#
#...............#..............#
#...............#..............#
#...............#..............#
#...............#........P.....#
#...............#..............#
#...............#..............#
#...............#..............#
#...............#..............#
##############..################
#..............................#
#..............................#
#..########..#..################
#..#.........#..################
#..#.........#..################
#..#......#..#..################
###########..#.......E.........#
#............#.................#
#............###################
#....................E.........#
#..............................#
################################