################################
#..............................#
#.............E................#
#.......#......................#
#.......#......................#
#.......#......................#
#.......#...P..................#
#.......#......................#
#.......#......................#
#.......#......................#
#.......#......................#
##########..####################
#..............................#
#..........#...................#
#..........#...................#
#..........#...................#
#..........#...#...............#
#..........#...#...............#
#..........#...#...............#
#.......E..#...#...............#
#..........#...#################
#..........#........E..........#
#..............................#
################################